og	oo	cg	co
University_of_Zagreb_C	London_School_of_Economics_A	Kingu2019s_College_London_A	Hobart_&amp;_William_Smith_A
University_College_London_D	Edinburgh_University_Debates_Union_B	Imperial_College_London_A	Vanderbilt_University_C
Harvard_College_B	Monash_University_C	University_of_Chicago_E	University_of_Queensland_A
Trinity_College_Dublin_University_Philosophical_Society_C	Chulalongkorn_University_A	Victoria_University_of_Wellington_A	Carleton_University_A
Williams_College_A	Debate_ITAM_A	Australian_National_University_A	De_La_Salle_University_B
Stanford_University_A	University_of_Sydney_B	McGill_Debating_Union_A	Princeton_University_C
Bangladesh_University_of_Engineering_and_Technology_C	University_of_Malaya_A	University_of_Tokyo_B	University_of_Chicago_C
University_of_Chicago_A	University_of_Auckland_A	University_of_Pennsylvania_A	Symbiosis_Law_School,_Pune_A
National_University_of_Singapore_A	Duke_University_B	University_of_Zagreb_E	University_of_Technology_Sydney_A
Vanderbilt_University_B	Independent_A	Monash_University_D	Universidad_de_Chile_A
Debattierklub_Wien_B	Bina_Nusantara_A	University_of_Waterloo_B	Stanford_University_E
Middlebury_Debate_society_C	Universitu00e9_du_Quu00e9bec_u00e0_Montru00e9al_A	Durham_Debate_B	Alneelain_University_A
The_University_of_Melbourne_C	Harvard_College_C	Cambridge_Union_Society_D	Universiti_Teknologi_MARA_A
Nanyang_Technological_University_B	Princeton_University_D	Duke_University_A	University_of_Chicago_D
Kwame_Nkrumah_University_of_Science_and_Technology_A	University_of_Western_Ontario_Debate_Society_B	National_University_of_Singapore_C	University_of_Sydney_F
Colgate_University_A	Tel_Aviv_University_D	Ben-Gurion_University_of_the_Negev_B	Nottingham_Trent_University_B
Wheaton_College_A	Sunway_University_A	Brown_University_B	University_of_Queensland_B
De_La_Salle_University_A	University_of_Otago_A	University_of_St_Andrews_A	University_of_Tokyo_A
Diponegoro_University_A	Reichman_University_B	Universidad_de_Almeru00eda_A	Universitas_Airlangga_A
The_Open_University_of_Israel_A	University_of_Auckland_B	Colgate_University_C	University_of_Auckland_C
McGill_Debating_Union_D	Stanford_University_C	Debattierklub_Wien_A	University_of_New_South_Wales_C
Nottingham_Trent_University_C	Middlebury_Debate_society_A	De_La_Salle_University_C	University_of_Alberta_B
Gadjah_Mada_University_A	Yale_University_C	Queen&#x27;s_Debating_Union_B	Nanyang_Technological_University_C
The_Oxford_Union_C	Hebrew_University_of_Jerusalem,_Israel_A	Harvard_College_E	Princeton_University_B
Harvard_College_D	Cornell_University_B	Monash_University_B	College_Historical_Society,_Trinity_College_Dublin_A
University_of_Sydney_D	Ateneo_de_Manila_University_A	London_School_of_Economics_B	Tel_Aviv_University_A
University_of_Zagreb_B	University_of_Bucharest_A	Cornell_University_A	Glasgow_University_Union_B
IT_Bandung_A	Tel_Aviv_University_B	Glasgow_University_Union_A	McGill_Debating_Union_C
Ben-Gurion_University_of_the_Negev_A	Vanderbilt_University_D	Lewis_&amp;_Clark_College_A	University_College_London_B
Princeton_University_A	Edinburgh_University_Debates_Union_C	Adelaide_University_A	The_University_of_Melbourne_A
The_Oxford_Union_B	Stanford_University_B	University_of_Sofia_B	Yale_-_NUS_A
University_of_New_South_Wales_B	University_of_New_South_Wales_A	Trinity_College_Dublin_University_Philosophical_Society_A	University_of_Sydney_A
Stanford_University_D	University_of_Tokyo_D	ASDV_Bonaparte_A	Singapore_Management_University_B
Sciences_Po_Reims_B	University_of_Chicago_B	Bates_College_A	Hart_House_B
National_University_of_Singapore_B	Brown_University_A	University_of_Western_Ontario_Debate_Society_A	Universidad_del_Rosario_A
Fordham_University_B	Kansas_State_University_A	United_States_Air_Force_Academy_A	Leiden_Debating_Union_A
University_of_Sydney_E	Ateneo_de_Manila_University_B	University_of_Zagreb_D	University_of_Alberta_A
Hart_House_C	Cambridge_Union_Society_B	Nanyang_Technological_University_A	Queen&#x27;s_Debating_Union_A
Universitas_Padjadjaran_A	Korea_University_Debate_Club_A	Swarthmore_College_B	University_of_Vermont_B
Copenhagen_Debating_Society_A	University_of_Athens_A	Reichman_University_A	Yale_University_D
Cambridge_Union_Society_A	University_of_Zagreb_A	Technion_A	Yale_University_A
College_Historical_Society,_Trinity_College_Dublin_B	University_of_California_Berkeley_B	University_College_London_C	Yonsei_University_A
University_of_Belgrade_A	Colgate_University_B	University_of_Hong_Kong_C	Alneelain_University_B
ETH_Zurich/University_of_Zurich_A	International_Islamic_University_Malaysia_C	Middlebury_Debate_society_B	University_of_Ottawa_A
London_School_of_Economics_C	Universitas_Indonesia_A	Ateneo_de_Manila_University_C	London_School_of_Economics_D
Singapore_Management_University_A	Strathmore_Debate_Society_A	University_of_Hong_Kong_D	University_of_Hong_Kong_A
The_Oxford_Union_D	The_Oxford_Union_A	University_of_the_Philippines_Diliman_A	Edinburgh_University_Debates_Union_A
McGill_Debating_Union_B	University_of_California,_Los_Angeles_A	Hart_House_A	University_of_Sydney_C
University_of_Coimbra_A	Davidson_College_A	University_of_Tokyo_C	University_of_Otago_C
Chulalongkorn_University_B	Universitas_Udayana_A	Copenhagen_Debating_Society_B	University_of_Khartoum_A
ETH_Zurich/University_of_Zurich_B	Stanford_University_F	Bangladesh_University_of_Engineering_and_Technology_D	Nazarbayev_University_A
University_of_Bucharest_B	Carleton_University_B	Wheaton_College_B	Bangladesh_University_of_Engineering_and_Technology_B
Comillas_A	International_Islamic_University_Malaysia_A	Vanderbilt_University_A	University_of_Wollongong_A
University_of_Western_Australia_A	Cambridge_Union_Society_C	University_of_National_and_World_Economy_A	Macquarie_University_A
Fordham_University_A	University_of_Hong_Kong_B	University_of_California_Berkeley_A	College_Historical_Society,_Trinity_College_Dublin_C
Sociedad_de_Debates_de_la_Universidad_Complutense_de_Madrid_A	International_Islamic_University_Malaysia_B	Berlin_Debating_Union_A	Split_Debating_Union_A
Tel_Aviv_University_C	Stanford_University_G	Swarthmore_College_A	Australian_National_University_B
Carleton_University_C	Imperial_College_London_B	Cornell_University_C	Bates_College_B
University_of_Aberdeen_A	Atma_Jaya_Catholic_University_of_Indonesia_A	University_of_New_South_Wales_D	Swarthmore_College_C
University_of_Western_Ontario_Debate_Society_C	University_of_Ghana_A	Universiti_Teknologi_MARA_B	University_College_Dublin_Literary_and_Historical_Society_A
Kwame_Nkrumah_University_of_Science_and_Technology_B	Bangladesh_University_of_Engineering_and_Technology_A	Monash_University_A	University_of_Vermont_C
Pontificia_Universidad_Catu00f3lica_del_Peru00fa_A	University_of_Sofia_A	Yale_University_B	Harvard_College_A
University_of_Vermont_A	Durham_Debate_A	National_Taiwan_University_A	University_of_Waterloo_A
Trinity_College_Dublin_University_Philosophical_Society_B	Sciences_Po_Reims_A	University_of_Otago_B	Universiti_Teknologi_MARA_C