og	oo	cg	co
Hart_House_C	Australian_National_University_B	Columbia_University_B	Berlin_Debating_Union_A
University_of_Belgrade_C	Macquarie_University_C	Kwame_Nkrumah_University_of_Science_and_Technology_C_ud83dudcbb	University_of_Western_Ontario_Debate_Society_B
Universidad_del_Rosario_A	University_of_Cape_Town_B	University_of_Bucharest,_Romania_B	The_University_Philosophical_Society_B
McGill_University_B	Princeton_University_F	University_of_New_South_Wales_E	Strathmore_University_A
University_of_Zagreb_A	Hankuk_University_of_Foreign_Studies_A	Indian_Institute_of_Technology,_Bombay_C	McGill_University_A
The_Hong_Kong_Polytechnic_University_A	The_University_of_Tokyo_D	Waseda_University,_Japan_X	Beijing_Foreign_Studies_University_A
University_of_Auckland_C	University_of_Auckland_B	University_of_California,_Berkeley_A	University_of_Belgrade_B
University_of_Cape_Town_C	University_of_Ottawa_A	National_University_of_Singapore_B	International_Islamic_University_Malaysia_B
Hart_House_B	University_of_Alberta_A	Higher_School_of_Economics_(Saint-Petersburg)_A	Swarthmore_College_A
Bina_Nusantara_University_A	Yonsei_University_PL	Hankuk_University_of_Foreign_Studies_B	University_of_Technology_MARA_D
Fordham_University_A	Brown_University_A	Victoria_University_of_Wellington_V1	University_of_Wollongong_A
University_of_New_South_Wales_A	Stanford_University_F	Nanyang_Technological_University_B	Queenu2019s_Debating_Union,_Queenu2019s_University_A
Brickfields_Asia_College,_Malaysia_B	Instituto_Tecnolu00f3gico_y_de_Estudios_Superiores_de_Monterrey_Campus_Estado_de_Mu00e9xico_A	Cornell_University_B	City_University_of_Hong_Kong_HK
Hanyang_University_A	Carleton_University_A	BeiHang_University_A	Yale-NUS_College_A
National_University_of_Singapore_A	University_of_Chicago_B	University_of_Belgrade_A	University_of_Queensland_A
Singapore_Management_University_C	Singapore_University_of_Social_Sciences_A	Singapore_Management_University_B	Foreign_Trade_University_A
University_of_Queensland_C	Middlebury_College_SS	Diplomatic_Academy_of_Vietnam_C	University_of_Waterloo,_Canada_B
Diplomatic_Academy_of_Vietnam_B	International_Islamic_University_Malaysia_A	University_of_Rochester_IL	Turan_A
University_of_Zimbabwe_A_ud83dudcbb	The_University_of_Hong_Kong_C	Split_Debating_Union_-_University_of_Split_A	Debatte_Karlsruhe_e.V.,_Germany_KIT
Swing_1	Chulalongkorn_University_A	Brickfields_Asia_College,_Malaysia_C	Thammasat_University,_Thailand_A
Nanyang_Technological_University_A	University_of_Sydney_Union_A	University_of_Chicago_A	Kwame_Nkrumah_University_of_Science_and_Technology_B
McGill_University_D	Durham_University_RS	University_of_Southern_California_A	University_College_London_A
Princeton_University_G	University_of_Western_Ontario_Debate_Society_A	University_of_Bucharest,_Romania_A	University_of_the_Philippines_Diliman_A
Colgate_University_A	President_University,_Indonesia_A	KNUST,_OBUASI_CAMPUS_A_ud83dudcbb	The_Chinese_University_of_Hong_Kong_A
Tsinghua_University_A	Jahangirnagar_University_A_ud83dudcbb	The_University_of_Hong_Kong_A	FPT_University_A
Chulalongkorn_University_C	Deen_Dayal_Upadhyaya_College_A	Duke_University_B	University_of_Oxford_C
Independent_University,_Bangladesh_A	The_University_Philosophical_Society_A	Stanford_University_B	Sciences_Po_A
Princeton_University_A	University_of_Chicago_C	Cornell_University_A	Harvard_College_C
University_of_Canterbury_A	University_of_Edinburgh_Debates_Union_A	Kwame_Nkrumah_University_of_Science_and_Technology_A	Ateneo_de_Manila_University_CF
Queenu2019s_Debating_Union,_Queenu2019s_University_B	Queensland_University_of_Technology_A	Macau_University_of_Science_and_Technology_C	Victoria_University_of_Wellington_2
National_University_of_Singapore_C	University_of_St_Andrews_A_ud83dudcbb	University_of_Waterloo,_Canada_C	Dartmouth_College_C
Harvard_College_E	Haifa_University_A_ud83dudcbb	Macquarie_University_A	University_of_Sydney_Union_C
Colgate_University_B	Brickfields_Asia_College,_Malaysia_A	University_of_Ilorin,_Nigeria_A_ud83dudcbb	Redacted_A_ud83dudcbb
Drexel_University_A_ud83dudcbb	Macau_University_of_Science_and_Technology_B	Fordham_University_B	University_of_Colombo,_Sri_Lanka_A_ud83dudcbb
Seoul_National_University_A	Multimedia_University_A	RMIT_University_A	Amherst_College_MZ
Durham_University_AW	University_of_the_Philippines_Los_Bau00f1os_A	University_of_Auckland_D	De_La_Salle_University_EJ
University_of_Sydney_Union_B	Sunway_University,_Malaysia_A	Hobart_and_William_Smith_Colleges_B	University_of_Sydney_Union_E
Tel_Aviv_University_A	University_of_California,_Los_Angeles_A	University_of_Oxford_A	Stanford_University_A
Waseda_University,_Japan_B	Midlands_State_University_A	Sunway_University,_Malaysia_B	Fordham_University_C
University_of_Pennsylvania_B	Stanford_University_G	Diplomatic_Academy_of_Vietnam_A	University_of_Arts_Belgrade_A
Colgate_University_C	Macquarie_University_B	FPT_University_IT	Middlebury_College_SW
Princeton_University_B	Stanford_University_C	Columbia_University_C	Weizmann_Institute_of_Science_A
De_La_Salle_University_PG	University_of_Technology_MARA_A	Delhi_Technological_University_1	Ateneo_de_Manila_University_LN
Cambridge_Union_Society_A	Yonsei_University_KC	Atma_Jaya_Catholic_University_Of_Indonesia_A	University_of_Belgrade_D
Singapore_Management_University_D	Universitas_Indonesia_1	Osaka_University,_Japan_A	Rhodes_University_1
McGill_University_C	The_University_of_Melbourne_C	Indian_Institute_of_Technology,_Bombay_B	Nanyang_Technological_University_C
The_University_of_Tokyo_C	Swing_3	University_of_Macau_B	Manado_State_University_MSU
University_of_Adelaide_1	University_of_Auckland_A	University_of_Queensland_B	Indira_Gandhi_National_Open_University_A
University_of_British_Columbia_A	Drexel_University_B	University_of_Chicago_D	Keio_University,_Japan_YF
University_of_Cape_Town_A	Brown_University_HK	Sciences_Po_C	Lewis_&amp;_Clark_College_A
University_of_Macau_A	Amherst_College_GD	The_University_of_Tokyo_B	Princeton_University_D
Swing_2	Doshisha_University_A	Bates_College_LA	FPT_University_Sirius
Vellore_Institute_of_Technology_A	Ateneo_de_Manila_University_SY	Duke_University_C	University_Of_Stellenbosch_Debate_Union_A
Indian_Institute_of_Technology,_Bombay_A	Yale_University_A	Stanford_University_D	Cambridge_Union_Society_B
Bates_College_MB	Symbiosis_Law_School,_Pune_A	Dartmouth_College_B	The_University_of_Tokyo_A
Stanford_University_E	Princeton_University_E	Columbia_University_A	Hart_House_A
Harvard_College_A	University_of_the_Philippines_Diliman_B	University_of_New_South_Wales_D	Cambridge_Union_Society_C
Australian_National_University_A	Nanyang_Technological_University_D	The_University_of_Hong_Kong_D	University_of_New_South_Wales_B
University_of_Alberta_B	Sekolah_Tinggi_Bahasa_Asing_-_Persahabatan_International_Asia_A	Hanyang_University_B	Davidson_College_1
The_University_of_Melbourne_B	Harvard_College_D	University_of_Sydney_Union_G	University_of_Pennsylvania_A
University_of_Oxford_B	University_of_New_South_Wales_C	University_of_Sydney_Union_F	University_of_Sydney_Union_D
Brawijaya_University_A	Chulalongkorn_University_B	Macau_University_of_Science_and_Technology_A	National_Economics_University_A
Cornell_University_C	Universidad_San_Francisco_de_Quito_DS	Fudan_University_A	Universitas_Udayana_A
Glasgow_University_Union_A	Sciences_Po_B	National_Law_Institute_University_Bhopal_A	University_of_Technology_MARA_C
De_La_Salle_University_HD	Vanderbilt_University_B	Harvard_College_B	Ateneo_de_Davao_University_A
National_University_of_Singapore_D	Ateneo_de_Manila_University_TV	Princeton_University_C	University_of_Technology_MARA_B
Telkom_University_Telkom	Ateneo_de_Manila_University_BG	The_University_of_Melbourne_A	Duke_University_A
University_of_Sydney_Union_H	Dartmouth_College_A	Bina_Nusantara_University_B	Yale_University_B
Universitas_Gadjah_Mada_A	University_of_Belgrade_E	Royal_Institute_of_Colombo_A	Joint
Cambridge_Union_Society_D	Trinity_College_Hist_(College_Historical_Society_Trinity_College_Dublin)_AH	Bates_College_CN	University_of_Warsaw,_Warsaw,_Poland_A
University_of_Waterloo,_Canada_A	The_University_of_Hong_Kong_B	Vanderbilt_University_A	University_of_Santo_Tomas_A
Hobart_and_William_Smith_Colleges_A	Midlands_State_University_B	University_College_London_B	Tenaga_Nasional_University,_Malaysia_A
Trinity_College_Hist_(College_Historical_Society_Trinity_College_Dublin)_CF	University_of_Alaska_Anchorage_A	Middlebury_College_CG	Keio_University,_Japan_SG