og	oo	cg	co
Neumann_&_Mittal	Safro_&_Hrovatin	Arbour_&_Low	Kalavagunta_&_Zuo
Yanuka_&_Shalom	Fast_&_Cosby	Ginat_&_Shacham	Yudai_&_Ichitaka
Dopson_&_Huston	HUTABARAT_&_Sofiano	Dougherty_&_Little	Dhillon_&_Afreen
Li_&_Tupper	Wilde_&_Freeman	Strevey_&_Najaf	Laksumanage_&_Tu
Haider_&_Braden	Naseer_&_Higgins	Chen_&_Cen	Sabljić_&_Žnidar
DASCALU_&_Lyhne	Mury_&_Antunes	Shales_&_Wyckoff	Stubblefield_&_West
Madzivire_&_Tong	Toomey_&_Ryan	Lafferty_&_Wu	Subramaniam_&_Li
Muwahid_&_Permpoonwiwat	Mulkeen_&_Bugler	DeBono_&_Rigaud	Buquet_&_Garcia
Tan_&_Jimenez-Rowe	Wu_&_Tyrrell-Knott	Cater_&_Tam	Samara_&_Armata
Simons_&_Chitwood	Hallward-Driemeier_&_Logue	LeBlanc_&_Ovsepyan	Hossain_&_Maahdie
Hoyte_&_Good	Roots_&_Yang	Lam_&_Rees	Butler_&_Septoff
Toh_&_Antony	Ren_&_Sangle	Turna_&_Kim	Adu_&_Sachs
Pavić_&_Juric	Mancuso_&_Damascena	Camp_&_Matheson	Fraley_&_Agho
Yakob_&_Kairon	Dhaliwal_&_Campion	Hussain_&_Lin	Huang_&_Qiu
Mohanty_&_Anderson	Kneppers_&_Proano	Leonhardt_&_Gumlia	Ho_&_Ryan
Kim_&_Wu	Xu_&_Khan	Raman_&_Armstrong	Perri_&_Tiefer
Brandi_&_Pimentel_Claut	Leyton_&_Triviño	He_&_Shi	Swing_11
Hernández_&_Mejia	Tang_&_Xu	Rosen_&_Miranda-Radbord	Konopka_&_Reischl
Naoki_&_Sugawara	Meylan_&_Pereira	Sundaram_&_Chatterjee	Ahsan_&_Karttikeyn
Jiang_&_Wu	Chang_&_Mauriello	Williamson_&_Anantham	Nitu_&_Chicus
Crousillat_&_Godos	Chen_&_Grover	Gyula_&_Agarwal	Yang_&_Banihani
Liu_&_Milicescu	Kimura_&_Pu	Nagda_&_Sayiram	Ferrell_&_Braden
Doyle_&_Leslie-Keefe	Kamath_&_Story	Legaspi_&_Alcañeses	Mor_&_Ben_Porat
Rădulescu_&_Woo	Vanni_&_Vanni	Slamova_&_Maaz	Tsuchiya_&_Yoshida
Zhao_&_Mehta	Lyndon_&_Machorro	Shead_&_Stephenson	Aryal_&_Amin
Nin_&_Gírio	Ong_&_Liu	Grizzle_&_Douglas	Rocha_&_Zimmer
Douglas_&_Freeland	Wolifson_&_Bako	Potocki_&_Ntshangase	Brayan_&_Chaffey
Tocani_&_Moore	Larkin_&_Katoch	Kazella_&_Thompson	Hodge_&_Paulin
Farook_&_Dhafer	Anwer_&_Haneef	Blemaster_&_Allen	Neiman_&_Gurevich
Mazur_&_Heanue	Rutkowski_&_Rohan	Sewell_&_Taylor	Smith_&_Zhu
Uy-Tioco_&_Ling	Montalvo_&_Mesa	Nuñez_del_Prado_&_Ezeta	Lee_&_Gong
Jackson_&_Tamkin	Lopez_Bombin_&_Bernárdez	Gao_&_Shen	Mangachena_&_Sibanda
Nayantara_&_Sharun	Boland_&_Kaur	Kleinman_&_Zhang	Pasikanti_&_Panzer
Alagu_&_Rizwan	Pravin_&_Nautiyal	Kawashima_&_Waldhalm	Tam_&_Chechi
Mikulic_&_Ryan	Soysal_&_Tawil	Zhou_&_Ham	Nanda_&_Kim
Bunnapradist_&_Mayman	Ferreira_&_Cheeseman	Allen_&_Doyle	Lee-Wlodek_&_Koszegi
Mahmud_&_Ehrenberg	Mahmood_&_Tabassum	Wolff_&_Wolf	Zaharim_&_WS
Vazquez_&_San_Roman	Washburn_&_Pigat	Chiang_&_Chaudhry	Zuo_&_Nam
Zhang_&_Cheng	Olden_&_McFadyen	Murphy_&_Arnold	Nelson_&_Pinnock
Bennett_&_Scott	Kagazume_&_Kumano	Álvarez_Carvajal_&_Rodriguez	Malkhasian_&_Losapio
O'Brien_&_Ludwin	Yagoda_&_Ren	Afford_&_Shan	Xaba_&_Mudzudza
Ritter_&_Castillo	Chen_&_Agrawal	Haq_&_Nayar	Lock_&_Gupta
Zhang_&_Mai	Tsutagawa_&_Mizutani	Cox_&_Icaza	Liu_&_Shu
Ragland_&_Liu	Mialma_&_Villarreal	Mckay-De_Carvalho_&_Frankiss	Godzinska_&_Walter
Jin_&_Lee	Batra_&_Granda-Scott	Orfanel_&_Ren	Berry_&_Easwaran
Gangasandra_&_Knight	Obinata_&_Sano	Song_&_Liu	Castro_&_Wong
Vaughan_&_Bremmer	Shem_&_Shukla	Swing_10	Swing_9
Knijnik_&_Dias	Gontla_&_Berlage	Chou_&_Suhita	Zhu_&_Chen
Gill_&_Negron	Kim_&_Kim	Ganesh_&_Chummun	Zu_&_Yu
McKellar_&_Woodruff	Puthucheary_&_Mentis	Chang_&_Thomas	Jain_&_Fazal
Zhang_&_Shi	Chen_&_Roebuck-Krautz	Mei_&_Parthasarathy	Lüscher_&_Huang
Shi_&_Chen	Sua_&_Rocha_Gonzalez	Koneru_&_Dubinsky	Sidhu_&_Haegeman
Borrego_Pablos_&_Colgrove	Rafay_&_Hahn	Mcharo_&_Pham	Lai_&_Lai
