og	oo	cg	co
Yudai_&_Ichitaka	Pasikanti_&_Panzer	Alagu_&_Rizwan	Obinata_&_Sano
Jackson_&_Tamkin	Brandi_&_Pimentel_Claut	Stubblefield_&_West	Shem_&_Shukla
Puthucheary_&_Mentis	Toomey_&_Ryan	Subramaniam_&_Li	Lafferty_&_Wu
Berry_&_Easwaran	Chen_&_Cen	Huang_&_Qiu	Larkin_&_Katoch
Afford_&_Shan	Tan_&_Jimenez-Rowe	Lai_&_Lai	Olden_&_McFadyen
Xu_&_Khan	Potocki_&_Ntshangase	Aryal_&_Amin	Vanni_&_Vanni
Safro_&_Hrovatin	Ho_&_Ryan	Tsuchiya_&_Yoshida	Williamson_&_Anantham
Strevey_&_Najaf	Gill_&_Negron	Vazquez_&_San_Roman	Zhang_&_Shi
Samara_&_Armata	Murphy_&_Arnold	Hernández_&_Mejia	Hossain_&_Maahdie
Lock_&_Gupta	Ahsan_&_Karttikeyn	Rutkowski_&_Rohan	Simons_&_Chitwood
Zhu_&_Chen	Dougherty_&_Little	Mckay-De_Carvalho_&_Frankiss	Lopez_Bombin_&_Bernárdez
Buquet_&_Garcia	Dhillon_&_Afreen	Pavić_&_Juric	Fast_&_Cosby
Boland_&_Kaur	Neiman_&_Gurevich	Tsutagawa_&_Mizutani	Rosen_&_Miranda-Radbord
Kleinman_&_Zhang	Sundaram_&_Chatterjee	Zuo_&_Nam	Sua_&_Rocha_Gonzalez
Dhaliwal_&_Campion	Sidhu_&_Haegeman	Mazur_&_Heanue	Leonhardt_&_Gumlia
Ferreira_&_Cheeseman	Rocha_&_Zimmer	Mancuso_&_Damascena	Kagazume_&_Kumano
Chang_&_Thomas	Hussain_&_Lin	Kneppers_&_Proano	Naseer_&_Higgins
Tang_&_Xu	Adu_&_Sachs	Wilde_&_Freeman	Jiang_&_Wu
Blemaster_&_Allen	Sabljić_&_Žnidar	Nanda_&_Kim	Wolifson_&_Bako
Ong_&_Liu	Camp_&_Matheson	Xaba_&_Mudzudza	Zu_&_Yu
Nagda_&_Sayiram	Butler_&_Septoff	Lüscher_&_Huang	Toh_&_Antony
Nitu_&_Chicus	Kim_&_Wu	Anwer_&_Haneef	Liu_&_Milicescu
Wolff_&_Wolf	Douglas_&_Freeland	Brayan_&_Chaffey	Raman_&_Armstrong
Legaspi_&_Alcañeses	Laksumanage_&_Tu	Zaharim_&_WS	Lyndon_&_Machorro
Nuñez_del_Prado_&_Ezeta	Ganesh_&_Chummun	Zhang_&_Mai	Nayantara_&_Sharun
Swing_10	Malkhasian_&_Losapio	Bennett_&_Scott	Bunnapradist_&_Mayman
HUTABARAT_&_Sofiano	Gao_&_Shen	Gangasandra_&_Knight	Fraley_&_Agho
Koneru_&_Dubinsky	Sewell_&_Taylor	Nelson_&_Pinnock	O'Brien_&_Ludwin
Tocani_&_Moore	Hoyte_&_Good	Chiang_&_Chaudhry	Yakob_&_Kairon
Mor_&_Ben_Porat	Rădulescu_&_Woo	Madzivire_&_Tong	Mahmood_&_Tabassum
Borrego_Pablos_&_Colgrove	Lee_&_Gong	Crousillat_&_Godos	Pravin_&_Nautiyal
Tam_&_Chechi	Muwahid_&_Permpoonwiwat	Montalvo_&_Mesa	Batra_&_Granda-Scott
Haider_&_Braden	Liu_&_Shu	Mikulic_&_Ryan	Uy-Tioco_&_Ling
Cox_&_Icaza	Ferrell_&_Braden	Farook_&_Dhafer	Chen_&_Roebuck-Krautz
Gyula_&_Agarwal	Mahmud_&_Ehrenberg	Konopka_&_Reischl	Arbour_&_Low
Turna_&_Kim	Haq_&_Nayar	Chang_&_Mauriello	Soysal_&_Tawil
Neumann_&_Mittal	Mohanty_&_Anderson	Kimura_&_Pu	Li_&_Tupper
Mcharo_&_Pham	Slamova_&_Maaz	Chen_&_Grover	Kim_&_Kim
Hallward-Driemeier_&_Logue	Zhou_&_Ham	Wu_&_Tyrrell-Knott	Ritter_&_Castillo
Orfanel_&_Ren	Shi_&_Chen	Yagoda_&_Ren	Kawashima_&_Waldhalm
Perri_&_Tiefer	Doyle_&_Leslie-Keefe	Kamath_&_Story	McKellar_&_Woodruff
Gontla_&_Berlage	Knijnik_&_Dias	Castro_&_Wong	Shales_&_Wyckoff
Lam_&_Rees	Cater_&_Tam	Jin_&_Lee	Chen_&_Agrawal
Meylan_&_Pereira	Grizzle_&_Douglas	Washburn_&_Pigat	Nin_&_Gírio
Allen_&_Doyle	Swing_11	Zhang_&_Cheng	Ragland_&_Liu
Jain_&_Fazal	Yang_&_Banihani	Shead_&_Stephenson	Kalavagunta_&_Zuo
Álvarez_Carvajal_&_Rodriguez	Vaughan_&_Bremmer	DASCALU_&_Lyhne	Ginat_&_Shacham
Kazella_&_Thompson	Mangachena_&_Sibanda	Smith_&_Zhu	Dopson_&_Huston
LeBlanc_&_Ovsepyan	DeBono_&_Rigaud	Godzinska_&_Walter	Leyton_&_Triviño
Naoki_&_Sugawara	Swing_9	Mury_&_Antunes	He_&_Shi
Yanuka_&_Shalom	Lee-Wlodek_&_Koszegi	Mulkeen_&_Bugler	Song_&_Liu
Roots_&_Yang	Chou_&_Suhita	Rafay_&_Hahn	Mialma_&_Villarreal
Ren_&_Sangle	Zhao_&_Mehta	Hodge_&_Paulin	Mei_&_Parthasarathy
