og	oo	cg	co
Malkhasian_&_Losapio	Bunnapradist_&_Mayman	Ferreira_&_Cheeseman	DASCALU_&_Lyhne
Zhou_&_Ham	Adu_&_Sachs	Naseer_&_Higgins	Mikulic_&_Ryan
Mor_&_Ben_Porat	Subramaniam_&_Li	Brayan_&_Chaffey	Puthucheary_&_Mentis
Obinata_&_Sano	Kazella_&_Thompson	Zuo_&_Nam	Tam_&_Chechi
Hallward-Driemeier_&_Logue	Boland_&_Kaur	Chen_&_Grover	Lai_&_Lai
McKellar_&_Woodruff	Jain_&_Fazal	Potocki_&_Ntshangase	Wolff_&_Wolf
Li_&_Tupper	Toh_&_Antony	Gill_&_Negron	Haider_&_Braden
Stubblefield_&_West	Rocha_&_Zimmer	Dhillon_&_Afreen	Ginat_&_Shacham
Lock_&_Gupta	Anwer_&_Haneef	Tan_&_Jimenez-Rowe	Samara_&_Armata
Simons_&_Chitwood	Crousillat_&_Godos	Tang_&_Xu	Chen_&_Cen
Leonhardt_&_Gumlia	Neiman_&_Gurevich	Nanda_&_Kim	Mcharo_&_Pham
Nelson_&_Pinnock	Lüscher_&_Huang	Ragland_&_Liu	Dougherty_&_Little
Swing_10	Fast_&_Cosby	Naoki_&_Sugawara	Mulkeen_&_Bugler
Wolifson_&_Bako	Lyndon_&_Machorro	Williamson_&_Anantham	Perri_&_Tiefer
Leyton_&_Triviño	Yagoda_&_Ren	Alagu_&_Rizwan	Olden_&_McFadyen
Nitu_&_Chicus	Cater_&_Tam	Liu_&_Shu	Kim_&_Kim
Zhang_&_Cheng	Nin_&_Gírio	Gontla_&_Berlage	Mancuso_&_Damascena
Lam_&_Rees	Zaharim_&_WS	Turna_&_Kim	Ho_&_Ryan
He_&_Shi	Yudai_&_Ichitaka	Buquet_&_Garcia	Rutkowski_&_Rohan
Fraley_&_Agho	Hernández_&_Mejia	Godzinska_&_Walter	Ong_&_Liu
Kalavagunta_&_Zuo	Laksumanage_&_Tu	Chang_&_Mauriello	Xu_&_Khan
Tsuchiya_&_Yoshida	Slamova_&_Maaz	Chang_&_Thomas	Konopka_&_Reischl
Lopez_Bombin_&_Bernárdez	Cox_&_Icaza	Shi_&_Chen	Haq_&_Nayar
Shead_&_Stephenson	Rădulescu_&_Woo	Sabljić_&_Žnidar	Raman_&_Armstrong
Chen_&_Agrawal	Nayantara_&_Sharun	Aryal_&_Amin	Chiang_&_Chaudhry
Pasikanti_&_Panzer	LeBlanc_&_Ovsepyan	Allen_&_Doyle	Castro_&_Wong
Montalvo_&_Mesa	Zu_&_Yu	Mazur_&_Heanue	Tocani_&_Moore
Chen_&_Roebuck-Krautz	Hussain_&_Lin	Douglas_&_Freeland	Madzivire_&_Tong
Mohanty_&_Anderson	Gyula_&_Agarwal	Blemaster_&_Allen	Kim_&_Wu
Kneppers_&_Proano	Mei_&_Parthasarathy	Neumann_&_Mittal	Kimura_&_Pu
Grizzle_&_Douglas	Camp_&_Matheson	Kawashima_&_Waldhalm	Batra_&_Granda-Scott
Muwahid_&_Permpoonwiwat	Pravin_&_Nautiyal	Kleinman_&_Zhang	Huang_&_Qiu
Mangachena_&_Sibanda	Zhang_&_Shi	Nuñez_del_Prado_&_Ezeta	Yakob_&_Kairon
Sewell_&_Taylor	Sundaram_&_Chatterjee	Ganesh_&_Chummun	Nagda_&_Sayiram
DeBono_&_Rigaud	Sidhu_&_Haegeman	Butler_&_Septoff	Mckay-De_Carvalho_&_Frankiss
Smith_&_Zhu	Hodge_&_Paulin	Borrego_Pablos_&_Colgrove	Strevey_&_Najaf
Kagazume_&_Kumano	Rafay_&_Hahn	Jackson_&_Tamkin	Song_&_Liu
Mury_&_Antunes	Gangasandra_&_Knight	Yanuka_&_Shalom	O'Brien_&_Ludwin
Wu_&_Tyrrell-Knott	Roots_&_Yang	Rosen_&_Miranda-Radbord	Gao_&_Shen
Mahmood_&_Tabassum	Jin_&_Lee	Uy-Tioco_&_Ling	Safro_&_Hrovatin
Shem_&_Shukla	Lee-Wlodek_&_Koszegi	Brandi_&_Pimentel_Claut	Álvarez_Carvajal_&_Rodriguez
Toomey_&_Ryan	Lafferty_&_Wu	Doyle_&_Leslie-Keefe	Kamath_&_Story
Soysal_&_Tawil	Jiang_&_Wu	Legaspi_&_Alcañeses	Farook_&_Dhafer
Dhaliwal_&_Campion	Ferrell_&_Braden	Mahmud_&_Ehrenberg	Arbour_&_Low
Hoyte_&_Good	Hossain_&_Maahdie	Sua_&_Rocha_Gonzalez	Zhang_&_Mai
Pavić_&_Juric	Knijnik_&_Dias	Meylan_&_Pereira	Koneru_&_Dubinsky
Larkin_&_Katoch	Chou_&_Suhita	Ritter_&_Castillo	Wilde_&_Freeman
Berry_&_Easwaran	Vanni_&_Vanni	Ren_&_Sangle	Yang_&_Banihani
Mialma_&_Villarreal	Washburn_&_Pigat	Ahsan_&_Karttikeyn	Xaba_&_Mudzudza
Vazquez_&_San_Roman	Lee_&_Gong	Liu_&_Milicescu	Zhao_&_Mehta
Zhu_&_Chen	Tsutagawa_&_Mizutani	Murphy_&_Arnold	Orfanel_&_Ren
Shales_&_Wyckoff	Afford_&_Shan	HUTABARAT_&_Sofiano	Dopson_&_Huston
